Chris Brewington | Teacher | christopher_brewington@hcpss.org
Tony Campitelli | Teacher | tony_campitelli@hcpss.org
Denise Chadwick | Teacher | denise_chadwick@hcpss.org
Te'Keisha Coates | Teacher | tekeisha_coates@hcpss.org
James DiPietro | Teacher | james_dipietro@hcpss.org
Gwendolyn Francis | Teacher | gwendolyn_francis@hcpss.org
Erika Goldsmith | Teacher | erika_goldsmith@hcpss.org
Glenn Hayman | Teacher | glenn_hayman@hcpss.org
Bradley Howell | Teacher | bradley_howell@hcpss.org
Tyson Laverick | Teacher | Work Study/Transition Coordinator | tyson_laverick@hcpss.org
Vicki Learn | Teacher | vicki_learn@hcpss.org
Katherine MacKie | Teacher | katherine_mackie@hcpss.org
Erica McGowan | Teacher | erica_mcgowan@hcpss.org
Paula Murphy | Teacher | paula_murphy@hcpss.org
Susan Rosner | Teacher | susan_rosner@hcpss.org
Lesley Ryan | Teacher | lesley_ryan@hcpss.org
Trevor Shea | Teacher | Trevor_Shea@hcpss.org
Ashley Smith | Teacher | ashley_smith@hcpss.org
Jennifer Smith | Teacher | jennifer_a_smith@hcpss.org
Jamie Twardowicz | Teacher | jamie_twardowicz@hcpss.org
Deborah Velencia | Teacher | deborah_velencia@hcpss.org
Cherlyne Yavo | Teacher | cherlyne_yavo@hcpss.org
Chiquita Brooks | Student Assistant | chiquita_brooks@hcpss.org
Emily Dotson | Paraeducator | emily_dotson@hcpss.org
Karen Filippelli | Paraeducator | karen_filippelli@hcpss.org
Ernest Gabriel | Paraeducator | ernest_gabriel_Jr@hcpss.org
Kim Hatfield | Paraeducator | kimberly_hatfield@hcpss.org
Stephanie Marvin | stephanie_marvin@hcpss.org
Peggy McClellan | Paraeducator | peggy_mcclellan@hcpss.org
Kendra Miller | Paraeducator | kendra_miller@hcpss.org
Helen Ollie | Paraeducator | helen_ollie@hcpss.org
Christina Petty | Student Assistant | christina_petty@hcpss.org
Shelby Plitt | Student Assistant | shelby_plitt@hcpss.org
Brandon Sanders | Paraeducator | brandon_sanders@hcpss.org
Ashleigh Schmitt | Paraeducator | ashleigh_schmitt@hcpss.org
Dena Smith | Paraeducator | dena_smith@hcpss.org
David Watson | Paraeducator | david_watson@hcpss.org