Reservoir High School
Kristen Shipley | Instructional Team Leader (ITL) | Kristen_Wood@hcpss.org
Lauren Alexander | Teacher | Lauren_Alexander@hcpss.org
Katuisia Antoine | Student Assistant
Dave Boteler | Adaptive P.E. Teacher | Dave_Boteler@hcpss.org
Timothy Caffrey | Teacher | Timothy_Caffrey@hcpss.org
Dion Chapman | Teacher | Dion_Chapman@hcpss.org
Marla Chisholm | Paraeducator | Marla_Chisholm@hcpss.org
Vanessa Clack | Teacher | Vanessa_Clack@hcpss.org
Victoria Daugherty | Teacher | Victoria_Daugherty@hcpss.org
Grace Dellinger | Work Study Coordinator/Transition Specialist | Grace_Dellinger@hcpss.org
Loretta Dospil-Farley | Teacher | Loretta_Dospil-Farley@hcpss.org
Brenda Dunlap | Student Assistant | Brenda_Dunlap@hcpss.org
Eunice French | Teacher | Eunice_French@hcpss.org
Candace Hammond | Student Assistant | Candace_Hammond@hcpss.org
Brian Harrison | Student Assistant | Brian_Harrison@hcpss.org
Michael Jones | Teacher | Michael_Jones@hcpss.org
Marisa Kavka | Paraeducator | Marisa_Kavka@hcpss.org
Alyssa Kuhne | Student Assistant | Alyssa_Kuhne@hcpss.org
Annica Langfield | Teacher | Annica_Langfield@hcpss.org
Shawn Lightfoot | Paraeducator | Shawn_Lightfoot@hcpss.org
Olivia Lumpkin | Paraeducator | Olivia_Lumpkin@hcpss.org
Maria Meza | Student Assistant | Maria_Meza@hcpss.org
Linda Nachenberg | Paraeducator | Linda_Nachenberg@hcpss.org
Emily Norof | Speech-Language Pathologist | Emily_Norof@hcpss.org
Pamela Paris | Teacher | Pamela_Paris@hcpss.org
John Perfetto | Teacher | John_Perfetto@hcpss.org
Jonathan Phillips | Teacher | Jonathan_Phillips@hcpss.org
Duron Pinkney | Paraeducator | Duron_Pinkney@hcpss.org
Brittney Pugh | Paraeducator | Brittney_Pugh@hcpss.org
Ericka Queen | Paraeducator | Ericka_Queen@hcpss.org
Sarah Ragusa | Teacher | Sarah_Ragusa@hcpss.org
Gina Richeson | Teacher | Gina_Richeson@hcpss.org
Deric Robinson | Paraeducator | Deric_Robinson@hcpss.org
Susan Scheer | Paraeducator | Susan_Scheer@hcpss.org
Denise Thomas | Teacher | Denise_Thomas@hcpss.org
Kelly Thompson | Teacher | Kelly_Thompson@hcpss.org
Lisa Thompson | Paraeducator | Lisa_Thompson1@hcpss.org
Brian Shouse | Paraeducator | Brian_Shouse@hcpss.org
Hannah Wascavage | Speech-Language Pathologist | Hannah_Wascavage@hcpss.org
Gina Witcher | Teacher | Gina_Witcher@hcpss.org

Atholton High School
Sheoma Aberdeen | Paraeducator | Sheoma_Aberdeen@hcpss.org
Nasreen Aslam | Student Assistant | Nasreen_Aslam@hcpss.org
Sidney Billups | Paraeducator | Sidney_Billups@hcpss.org
Amy Bollt | Teacher | Amy_Bollt@hcpss.org
Erin Bourque | Teacher | Erin_Bourque@hcpss.org
Stephen Braun | Teacher | Stephen_Braun@hcpss.org
Mary Brock | Teacher | Mary_Brock@hcpss.org
Carly Bruzga | Teacher | Carly_Bruzga@hcpss.org
Susan Caldwell | Speech/Language Pathologist | Susan_Caldwell@hcpss.org
Peter Coburger | Paraeducator | Peter_Coburger@hcpss.org
Michael Cummings | Paraeducator | Michael_Cummings@hcpss.org
Elizabeth Dooley | Transition Specialist | Elizabeth_Dooley@hcpss.org
Lori Finney | Paraeducator | Lori_Finney@hcpss.org
Kara Godman | Vision Specialist | Kara_Godman@hcpss.org
Carly Graeff | Student Assistant | Carly_Graeff@hcpss.org
Anitra Harris | Student Assistant | Anitra_Harris@hcpss.org
Rachel Holtzman | Teacher | Rachel_Holtzman@hcpss.org
Michael Lake | Paraeducator | michael_lake@hcpss.org
Tamara Layne | Speech/Language Pathologist | Tamara_Layne@hcpss.org
Ben Lefkowitz | Student Assistant | benjamin_lefkowitz@hcpss.org
Barbara Lokitis | Occupational Therapist | Barbara_Lokitis@hcpss.org
MaryJo Lukowski | Teacher | MaryJo_Lukowski@hcpss.org
Penny Luu | Student Assistant | Penny_Luu@hcpss.org
Dionne Mayers | Interpreter | Dionne_Mayers@hcpss.org
Michelle Mercier | Teacher | Michelle_Mercier@hcpss.org
Aeriell Moore | Student Assistant | Aeriell_Moore@hcpss.org
Wanda Muir | Paraeducator | Wanda_Muir@hcpss.org
Brian Murphy | Teacher | Brian_Murphy@hcpss.org
Hannah Oh | Para Educator | Hyung_Kyum_Oh@hcpss.org
Matthew Pacheco | Paraeducator | Matthew_Pacheco@hcpss.org
Chad Reuss | Teacher | Chad_Reuss@hcpss.org
Caitlin Rogers | Paraeducator | Caitlin_Rogers@hcpss.org
Monica Shah | Teacher, Instructional Team Leader | Monica_Shah@hcpss.org
Sean Smith | Teacher | Sean_Smith@hcpss.org
Deanna Thompson-Johnson | Student Assistant | Deanna_Thompson_Johnson@hcpss.org
Kate Trout | Teacher | Dorothy_Trout@hcpss.org
Georgette Washington | Teacher | Georgette_Washington@hcpss.org
Daniel White | Teacher | Daniel_White1@hcpss.org

Centennial High School
Patricia Cummings | Paraeducator | patricia_cummings@hcpss.org
Albina David | Paraeducator | albina_david@hcpss.org
Corey Eudell | Paraeducator | corey_eudell@hcpss.org
Edward Fowler | Paraeducator | edward_fowler@hcpss.org
Brandon Jackson | Paraeducator | brandon_jackson@hcpss.org
Rhonda Larity | Student Assistant | rhonda_larity@hcpss.org
Tina Lewis | Paraeducator | tina_lewis1@hcpss.org
Jared Mantegna | Paraeducator | jared_mantegna@hcpss.org
Trisha McDonald | Paraeducator | patricia_mcdonald@hcpss.org
Lisa Robinson | Paraeducator | lisa_robinson@hcpss.org
Victoria Sattler | Paraeducator | victoria_sattler@hcpss.org
Jessica Stockham | Paraeducator | jessica_stockham@hcpss.org

Glenelg High School
Jeremy Snyder | Teacher, Instructional Team Leader | jeremy_snyder@hcpss.org
Marcy Burkom | Teacher | marcy_burkom@hcpss.org
David Chalecki | Teacher | david_chalecki@hcpss.org | 410-313-5528
Margaret Condon | Speech Pathologist | margaret_condon@hcpss.org
Austin Donmoyer | Teacher | austin_donmoyer@hcpss.org
Katherine Grebe | Teacher | katherine_grebe@hcpss.org
Joshua Hatmaker | Teacher | joshua_hatmaker@hcpss.org
Lisa McCollum | Teacher | lisa_mccollum@hcpss.org
Jon Miller | Teacher | jonathan_miller@hcpss.org
Cynthia Naranjo | Work Study/Transition Coordinator | cynthia_naranjo@hcpss.org
Erin Powell | Visual/Hearing Impaired Teacher | erin_powell@hcpss.org
Michelle Punte | Teacher | michelle_punte@hcpss.org | 410-313-5528
Maureen Roberson | Teacher | maureen_roberson@hcpss.org
Bill VanBuskirk | Teacher of the Visually Impaired | bill_vanbuskirk@hcpss.org | 410-313-5528
Cherie Weld | Teacher | cherie_weld@hcpss.org | 410-313-5528
Emilia Burns | Paraeducator | emilia_burns@hcpss.org
Noelle Chapman | Paraeducator | noelle_chapman@hcpss.org
Kayla Christian | Paraeducator | kayla_christian@hcpss.org
Denise Dixon | Paraeducator | denise_dixon@hcpss.org
Sarah Floyd | Paraeducator | sarah_fortin@hcpss.org
Danielle Gray | Student Assistant | danielle_gray@hcpss.org
Alaa Gimi | Student Assistant | alaa_hummad_gimi@hcpss.org | 410-313-5528
Sara Hall | Paraeducator | sara_hall@hcpss.org | 410-313-5528
Wanda Hudson | Paraeducator | wanda_hudson@hcpss.org | 410-313-5528
Angela Sales | Paraeducator | angela_sales@hcpss.org
Donna Sales | Paraeducator | donna_sales@hcpss.org | 410-313-5528
Stephanie Siegmann | Paraeducator | stephanie_siegmann@hcpss.org
Jennifer Weinstein | Student Assistant | jennifer_weinstein@hcpss.org

Hammond High School
William Yeo | ITL | william_yeo@hcpss.org
Daniel Amacher | Paraeducator | daniel_amacher@hcpss.org
Sheryl Baker | Teacher | Sheryl_Baker@hcpss.org
Diane Brown | Paraeducator | diane_brown@hcpss.org
Patrick Burns | Paraeducator | patrick_burns1@hcpss.org
Candace Colonna | Paraeducator | Candace_Colonna@hcpss.org
Elaine Davis | Paraeducator | elaine_davis@hcpss.org
Nicholas Dewind | Teacher - JV Boys Lacrosse Coach | nicholas_dewind@hcpss.org
Mehr Dhillon | Teacher | Mehr_Dhillon@hcpss.org
John Fisher IV | Teacher | john_fisheriv@hcpss.org
Lois Geyer | Paraeducator | Lois_Geyer@hcpss.org
Solomon Hawkins | Student Assistant | solomon_hawkins@hcpss.org
Laura Henry | Teacher | Laura_Henry@hcpss.org | Website
Alyssa Keating | Teacher | alyssa_keating@hcpss.org
Robert Kordon | Teacher | Robert_Kordon@hcpss.org
Teresa Macek | Teacher | Teresa_Macek@hcpss.org
Kristine Martinez | Teacher | Kristine_Martinez@hcpss.org | Website
Cecilia McDonald | Paraeducator | Cecilia_McDonald@hcpss.org
Nancy Moreira | Student Assistant | nancy_moreira@hcpss.org
Kraig Nussbaum | ED Coordinator | kraig_nussbaum@hcpss.org
Glenna Nyanjom | Paraeducator | Glenna_Nyanjom@hcpss.org
Adriana Ortega-Sixtos | Paraeducator | adriana_ortega-sixtos@hcpss.org
Katie Podson | Teacher | Katie_Podson@hcpss.org
Pamela Rahnama | Teacher | pamela_rahnama@hcpss.org
Theresa Reisman | Paraeducator | Theresa_Reisman@hcpss.org
Amy Salvesen | Teacher | Amy_Salvesen@hcpss.org
Sandra Scott | Paraeducator | sandra_scott@hcpss.org
Steven Sherman | Teacher | steven_sherman@hcpss.org
Jenebah Tarbleh | Student Assistant | jenebah_tarbleh@hcpss.org
Kim Williams | Teacher, Head Girls Cross Country Coach | kimberley_williams@hcpss.org

Howard High School
Barbara Baker | Special Ed ITL | barbara_baker@hcpss.org
Georgette Allsup | Teacher | georgette_allsup@hcpss.org
Michelle Bowers | Teacher | michelle_bowers@hcpss.org
Venice Burrows | Teacher | Venice_Burrows@hcpss.org
Shea Conway | Teacher, Assistant Boys Lacrosse Coach | shea_conway@hcpss.org
Kristie Fausel | Teacher | kristie_fausel@hcpss.org
Sarah Hammond | Teacher | sarah_hammond@hcpss.org
John Isberg | Teacher | John_Isberg@hcpss.org
Lisa Jacob Jacob | Teacher | lisa_jacob@hcpss.org
Daneace Jeffery | Teacher | Daneace_Jeffery@hcpss.org
Matthew Jens | Teacher | Matthew_Jens@hcpss.org
Michael Kellaher | Teacher | Michael_Kellaher@hcpss.org
Kathleen Kravitz | Teacher | Kathleen_Kravitz@hcpss.org
Jessica McKay | Teacher, JV Girls Soccer Coach, JV Softball Coach | Jessica_McKay@hcpss.org
Antonnika Owens | Teacher | antonnika_owens@hcpss.org
Laura Parsons | Teacher/ Work Study/ Transition Specialist | Laura_Parsons@hcpss.org
Christopher Price | Teacher | christopher_price@hcpss.org
Tracey Richards | Teacher | Tracey_Richards@hcpss.org
Sharon Sowada | Teacher | Sharon_Sowada@hcpss.org | Website
William Tu | Teacher | William_Tu@hcpss.org
Jessica Young | Teacher | jessica_young@hcpss.org
Shante Young | Teacher | Shante_Young@hcpss.org
Patty Allis-May | Paraeducator | Patty_Allis-May@hcpss.org
Irisha Avery | Student Assistant | Irisha_avery@hcpss.org
Alicia Bell | Speech Language Pathologist | alicia_bell@hcpss.org
Erica Santiago | Speech Language Pathologist | erica_santiago@hcpss.org
Barbara Lokitis | Occupational Therapist | barbara_lokitis@hcpss.org
Kara Goodman | Teacher of the Blind and Visually Impaired | Kara_Godman@hcpss.org
Banitta Blesson | Student Assistant | banitta_blesson@hcpss.org
Freda Crenshaw-Michener | Student Assistant | freda_crenshaw-michener@hcpss.org
Kathryn Davis | Paraeducator | Kathryn_Davis@hcpss.org
Barbara Ek | Student Assistant | Barbara_Ek@hcpss.org
Anne Handy | Paraeducator | Anne_Handy@hcpss.org
Donna Hayman | Paraeducator | Donna_Hayman@hcpss.org
Lynda Hong | Paraeducator | Lynda_Hong@hcpss.org
Phyllis Osofsky | Paraeducator | phyllis_osofsky@hcpss.org
Willie Spence | Paraeducator | Willie_Spence@hcpss.org
Mi Soon Lee | Student Assistant | misoon_lee@hcpss.org
Mike Twardowicz | Paraeducator | michael_twardowicz@hcpss.org
Tyler Wade | Paraeducator Alternative Education | Tyler_Wade@hcpss.org
Aaron Walker | Paraeducator | aaron_walker@hcpss.org
Brandye Willis | Paraeducator | brandye_willis@hcpss.org
Samantha Carrigan | TE | samantha_carrigan@hcpss.org

Long Reach High School
John Brewer | Paraeducator | John_Brewer@hcpss.org
Heather Clausen | Teacher, Varsity Softball | heather_clausen@hcpss.org
Melissa Cotton | Teacher, Varsity Softball | melissa_cotton@hcpss.org
Lauren Corrigan | Speech Pathologist | Lauren_Corrigan@hcpss.org
Karen Covington | Teacher | Karen_Covington@hcpss.org
Geraldine Dorzin | Paraeducator | Geraldine_Dorzin@hcpss.org
Courtney Dzbynski | Paraeducator | courtney_dzbynski@hcpss.org
Reginald Faulcon | Teacher | Reginald_Faulcon@hcpss.org
Chris Klein | Speech Pathologist | Christopher_Klein@hcpss.org
Janet Kim | Teacher, Allied Soccer Coach, Allied Softball Coach | janet_kim@hcpss.org
Daniel Lally | Teacher | daniel_lally@hcpss.org
Kim Levin | Paraeducator | kimberly_levin@hcpss.org
Angelle V. Miller | Special Education Teacher | Angelle_Miller@hcpss.org
Tonia Miser | Paraeducator | tonia_miser@hcpss.org
Gina Naimaster | Paraeducator | gina_naimaster@hcpss.org
Lilian Njenga | Teacher | lilian_njenga@hcpss.org
Candace Pretty | Paraeductor | candace_pretty@hcpss.org
Brandon Roberson | Paraeducator | brandon_roberson@hcpss.org
Essie Sanders | Student Assistant | essie_sanders@hcpss.org
Steven Satterfield | Teacher | steven_satterfield@hcpss.org
Shelby Simpson | Paraeducator | shelby_simpson@hcpss.org
Allyson Toronto | Teacher | Allyson_Toronto@hcpss.org
Shavonne Washington | Teacher | Shavonne_Washington@hcpss.org
MaryAnn Walker | Paraeducator | maryann_walker@hcpss.org
Rebecca Weinberg | Special Education Teacher | rebecca_weinberg@hcpss.org
Shonte Wicks | Paraeducator | shonte_wicks@hcpss.org
Cathy Wiley | Teacher | cathy_wiley@hcpss.org
Artis Wilkins | Teacher | Artis_Wilkins@hcpss.org
Keith Williams | Teacher, Varsity Girls Basketball Coach | keith_williams@hcpss.org
Jamie Willis | Teacher, Varsity Football Coach, Allied Bowling Coach | Jamie_Willis@hcpss.org
William Miller | Teacher | william_miller@hcpss.org | 410-313-7117
Lauren Bhatia | Teacher | lauren_bhatia@hcpss.org | 410-313-7117
Clifton Green | Teacher | clifton_green@hcpss.org | 410-313-7117
Brittney Beamon | Teacher | brittney_beamon@hcpss.org | 410-313-7117
Katalina Brown | Student Assistant | katalina_brown@hcpss.org | 410-313-7117

Mariotts Ridge High School
Thea Baker | Paraeducator | thea_baker@hcpss.org
Malinda Burroughs | Paraeducator | malinda_burroughs@hcpss.org
Michelle Dean | Special Educator | michelle_dean@hcpss.org
Robin Eakle | Paraeducator | robin_eakle@hcpss.org
Jessica Feldman | Paraeducator | jessica_feldman@hcpss.org
Meredith Gregoire-Cope | Transition Coordinator | meredith_gregoire-cope@hcpss.org
Carly Gregory | Special Educator | carly_gregory@hcpss.org
Matt Hempstead | Special Educator | matthew_hempstead@hcpss.org
Daniel Hirsch | Special Educator | daniel_hirsch@hcpss.org
Rebecca Holtz | Paraeducator | rebecca_holtz@hcpss.org
Olive Jagne-Shaw | Student Assistant | olive_jagne-shaw@hcpss.org
Katelin Johnson | Special Educator | katelin_johnson@hcpss.org
Cimarron Ludwig | Speech Pathologist | cimarron_ludwig@hcpss.org
Marie Jones | Paraeducator | consuela_jones@hcpss.org
Molly Milani | Special Educator | molly_milani@hcpss.org
Alexis Murrell | Student Assistant | alexis_murrell@hcpss.org
Glen Newhall | Paraeducator | glen_newhall@hcpss.org
Zachary Richeson | Special Educator | zachary_richeson@hcpss.org
Matthew Richter | Special Educator | matthew_richter@hcpss.org
Amanda Shearer | Special Educator, Instructional Team Leader | amanda_shearer@hcpss.org
Douglas Smith | Special Educator | douglas_smith@hcpss.org
Tyesha Smith | Student Assistant | tyesha_smith@hcpss.org
Timothy Sparzak | Special Educator | timothy_sparzak@hcpss.org
Kelly Washington | Paraeducator | kelly_washington@hcpss.org
Morgan Williams | Student Assistant | morgan_williams@hcpss.org

Mount Hebron High School
Matthew Aubin | Teacher | Matthew_Aubin@hcpss.org
Heather Beck | Interpreter | Heather_Beck@hcpss.org
Kara Brooks-Odom | Teacher | Kara_Brooks-Odom@hcpss.org
Laurie Daman | Teacher for the Deaf/Hard of Hearing | Laurie_Daman@hcpss.org
Kim Durkan | Interpreter | Kimberly_Durkan@hcpss.org
Christine Ebbert | Interpreter | Christine_Ebbert@hcpss.org
Patricia Ewart | Teacher | Patricia_Ewart@hcpss.org
Shawn Frederick | Teacher | Shawn_Frederick@hcpss.org
Janna Freishtat | Teacher | Janna_Freishtat@hcpss.org
Shauna Gilbert | Teacher | Shauna_Gilbert@hcpss.org
Karen Greenhorn | Teacher | Karen_Greenhorn@hcpss.org
Lisa Hamlett | Instructional Team Leader | Lisa_Hamlett@hcpss.org
John Jentsch | Teacher | John_Jentsch@hcpss.org
Barbara Lokitis | Occupational Therapist | Barbara_Lokitis@hcpss.org
Christopher Lombardi | Teacher | Christopher_Lombardi@hcpss.org
Karol Moore | Physical Therapist | Karol_Moore@hcpss.org
Leanne ONeill | Teacher | Leanne_ONeill@hcpss.org
Robin Page | Interpreter | Robin_Page@hcpss.org
Rebecca Ramsburg | Work Study | Rebecca_Ramsburg@hcpss.org
Denise Reid-Dubose | Speech Pathologist | Denise_Reid-Dubose@hcpss.org
Daniel Salemie | Teacher | Daniel_Salemie@hcpss.org
Erin Schiff | Teacher | Erin_Schiff@hcpss.org
Margaret Wolters | Teacher | Margaret_Wolters@hcpss.org
OPEN POSITION | Teacher | Open_Positionl@hcpss.org

Oakland Mills High School
Chiquita Brooks | Student Assistant | chiquita_brooks@hcpss.org
Emily Dotson | Paraeducator | emily_dotson@hcpss.org
Karen Filippelli | Paraeducator | karen_filippelli@hcpss.org
Ernest Gabriel | Paraeducator | ernest_gabriel_Jr@hcpss.org
Kim Hatfield | Paraeducator | kimberly_hatfield@hcpss.org
Stephanie Marvin | stephanie_marvin@hcpss.org
Peggy McClellan | Paraeducator | peggy_mcclellan@hcpss.org
Kendra Miller | Paraeducator | kendra_miller@hcpss.org
Helen Ollie | Paraeducator | helen_ollie@hcpss.org
Christina Petty | Student Assistant | christina_petty@hcpss.org
Shelby Plitt | Student Assistant | shelby_plitt@hcpss.org
Brandon Sanders | Paraeducator | brandon_sanders@hcpss.org
Ashleigh Schmitt | Paraeducator | ashleigh_schmitt@hcpss.org
Dena Smith | Paraeducator | dena_smith@hcpss.org
David Watson | Paraeducator | david_watson@hcpss.org

Wilde Lake High School
Lija Schaffle | ITL Special Education | lija_schaffle@hcpss.org
Anthony Bell | Teacher/ Varsity Boys Lacrosse Head Coach | anthony_bell@hcpss.org
Miles Blount | Paraeducator | miles_blount@hcpss.org
Edward Caldwell | Paraeducator | edward_caldwell@hcpss.org
Kameka Coates | Paraeducator | kameka_coates@hcpss.org
Laura Collier | Teacher | laura_collier@hcpss.org
Kristina Dronenburg | Teacher, Head Varsity Softball Coach | kristina_dronenburg@hcpss.org
Mary Folsom | Teacher | mary_folsom@hcpss.org
Kaitlyn Gezik | Teacher | kaitlyn_gezik@hcpss.org
Daniel Hill | Teacher | daniel_hill@hcpss.org
Nikki Kosecki | Teacher | nikki_kosecki@hcpss.org
Chris Lienhard | Teacher | chris_lienhard@hcpss.org
Teresa Lienhard | Teacher | teresa_lienhard@hcpss.org
Barbara Lokitis | Occupational Therapist | barbara_lokitis@hcpss.org
Indria Mason | Paraeducator | indria_mason@hcpss.org
Kelly McEachern | Paraeducator | Kelly_McEachern@hcpss.org
Suzanne Mesol | Teacher/Transition Specialist | suzanne_mesol@hcpss.org
Latonya Miller | Paraeducator | latonya_miller@hcpss.org
Karol Moore | Physical Therapist | karol_moore@hcpss.org
David Nesbitt | Paraeducator | david_nesbitt@hcpss.org
Kristyn Neubauer | Teacher/Head Coach Girls Soccer | kristyn_neubauer@hcpss.org
LaToya Pinkney | Paraeducator | latoya_pinkney@hcpss.org
Sabrina Reely | Teacher | sabrina_reely@hcpss.org
Marielle Sexton | Teacher | Marielle_Sexton@hcpss.org
Alice Slater | Teacher | alice_slater@hcpss.org
Coretta Spriggs | Paraeducator | coretta_spriggs@hcpss.org
Stephanie Tam | Teacher | stephanie_tam@hcpss.org
Brenda Terry | Paraeducator | brenda_terry@hcpss.org
Emily Townsend | Speech Therapist | emily_townsend@hcpss.org
David Young | Teacher | david_young@hcpss.org

River Hill High School
Kelly Sandok | ITL | Kelly_Sandok@hcpss.org
Wisty Battles | Wisty_Battles@hcpss.org
Pamela Colombel | Pamela_Colombel@hcpss.org
Lindsey Glascock | Lindsey_Glascock@hcpss.org
Thomas Gruneberg | Thomas_Gruneberg@hcpss.org
Cathleen Maloney | Cathleen_Maloney@hcpss.org
Kelley Pfefferkorn | Kelley_Pfefferkorn@hcpss.org
Roo Saglimbeni | Roo_Saglimbeni@hcpss.org
Meghan Smallwood | Work Study | Meghan_Smallwood@hcpss.org
Jessica Weldon | Speech/Language Pathologist | Jessica_Weldon@hcpss.org
Cindy Alvey | Paraeducator | Cindy_Alvey@hcpss.org
Freda Crenshaw-Michener | Paraeducator | Freda_Crenshaw-Michener@hcpss.org
Octavia Dukes-Georges | Paraeducator | Octavia_Dukes-Georges@hcpss.org
Jessica Garry | Paraeducator | Jessica_Garry@hcpss.org
Emily Hazzard | Paraeducator | Emily_Hazzard@hcpss.org
Breaon Klein-Hebron | Paraeducator | Breaon_Klein-Hebron@hcpss.org
Jordan Knisley | Paraeducator | Jordan_Knisley@hcpss.org
Lauren Martin | Student Assistant

Wilde Lake Middle School
Nicole Regan | Special Education Team Leader | Nicole_Regan@hcpss.org
Erik Pecukonis | Special Educator | Erik_Pecukonis@hcpss.org
Adrien Johnson-Brown | Paraeducator | Adrien_Johnson-Brown@hcpss.org
Ani Lalli | Paraeducator | Ani_Lalli@hcpss.org
Paraswati Sarkar | Special Education Teacher | Paraswati_Sarkar@hcpss.org
Rebecca Delaney | Academic Life Skills Regional Teacher | Rebecca_Delaney@hcpss.org
William Bellamy | Paraeducator-Regional ALS | William_j_Bellamy@hcpss.org
Ronda Harrison | Paraeducator | Ronda_Harrison@hcpss.org
Mechela Rachel | Teacher - ALS Regional | mechela_rachel@hcpss.org
Joseph Young | Teacher- ALS | Joseph_Young@hcpss.org
Beverly Matthews | Paraeducator | Beverly_Matthews@hcpss.org
Kathleen Newberry | Paraeducator | kathleen_newberry1@hcpss.org
Onita Kirkpatrick | Paraeducator
Brian Long | Paraeducator | brian_long@hcpss.org

Thomas Viaduct
Deborah Barnes | Special Education Paraeducator | Deborah_Barnes@hcpss.org
Kye Carter | Special Education Paraeducator | Kye_Carter@hcpss.org
Rochelle Chauncey | Special Education Paraeducator | Rochelle_Chauncey@hcpss.org
Darcie Hildebrand | Special Education Paraeducator | Darcie_Hildebrand@hcpss.org
Archana Nandi | Special Education Paraeducator | Archana_Nandi@hcpss.org
Latha Narayanan | Special Education Paraeducator | Latha_Narayanan@hcpss.org
Jennifer Nelson | Math Paraeducator | Jennifer_Nelson@hcpss.org
Elisania Nunez | ESOL Paraeducator | Elisania_Nunez@hcpss.org
Menka Patel | Special Education Paraeducator | Menka_Patel@hcpss.org
Christine Peed | Student Assistant | Christine_Peed@hcpss.org
Binod Puri | Special Education Paraeducator
Chaville Washington | Alternative Education Paraeducator | Chaville_Washington@hcpss.org
Brooks Wetzelberger | Media Paraeducator | Brooks_Wetzelberger@hcpss.org

Patuxent Valley Middle School
Robbins, Eleanor | Special Education Instructional Team Leader | Eleanor_Robbins@hcpss.org
Harrell, Fumi | Special Education | Fumi_Harrell@hcpss.org
Ingram, Joan | Joan_Ingram@hcpss.org
Jones, Martina | Special Education | Martina_Jones@hcpss.org
Kruzic, Ariana | Special Education | Ariana_Kruzic@hcpss.org
Reeves, Leigh Ann | Special Education - ALS | Leigh_Ann_Reeves@hcpss.org
Ross, Brandon | Special Education | Brandon_Ross@hcpss.org
Schwartzbart, Brett | Special Ed Adaptive PE
Varner, Meredith | Special Education | Meredith_Varner@hcpss.org
Whalen, Pam | Special Education | Pamela_Whalen@hcpss.org
Witherspoon, TaVar | Special Education | TaVar_Witherspoon@hcpss.org
Bonner, Ralph | Special Education Paraprofessional | Ralph_Bonner@hcpss.org
Bradford, Sarita | Special Education Paraeducator | Sarita_Bradford@hcpss.org
Calato, Lauren | Para | Lauren_Calato@hcpss.org
Hopewell, Juliet | Special Education Paraeducator | Juliet_Hopewell@hcpss.org
Mason, Darzell | Special Education Paraeducator | Darzell_Mason@hcpss.org
Sandler, Amy | Special Education Paraeducator | Amy_Sandler@hcpss.org
Sweeney, Sarah | Special Education Paraeducator | Sarah_Sweeney@hcpss.org
Vaughn, Pamela | Special Education Paraeducator | Pamela_Vaughn@hcpss.org
Pierre, Islande | Student Assistant | Islande_Pierre@hcpss.org

Patapsco
Ethel Altman | Paraeducator | Ethel_Altman@hcpss.org
Samina Bilquis | Student Assistant | bilquis_samina@hcpss.org
Lori Birmingham | Paraeducator | Lori_Birmingham@hcpss.org
Christine Crosson | Student Assistant | Christine_Crosson@hcpss.org
Karen Harman | Teacher | Karen_Harman@hcpss.org
Paige Holly | Speech Pathologist | Camille_Holly@hcpss.org
Inna Kotyleva-Roberts | Paraeducator | Inna_Kotyleva-Roberts@hcpss.org
Jessica Oby | Paraeducator | Jessica_Oby@hcpss.org
Daniel Pletcher | Paraeducator | Daniel_Pletcher@hcpss.org
Stephen Schumacher | Teacher | Stephen_Schumacher@hcpss.org
Kassie Stubleski | Teacher | Kathryn_Stubleski@hcpss.org
Michelle Whelan | Special Education Team Leader | Michelle_Whelan@hcpss.org
Georgia Whyte | Special Educator | Georgia_Whyte@hcpss.org

Murray Hill Middle School
Barry Blumenstock | Special Education - Student Assistant | barry_blumenstock@hcpss.org
Brian Curry | Special Education Paraeducator - Alternative Education Program | brian_curry@hcpss.org
Ashley Gurwah | Special Education Paraeducator - Regional Program | ashley_gurwah@hcpss.org
Conner Hall | Special Education Paraeducator | conner_hall@hcpss.org
Rekha Lakhanpal | Paraeducator ALS | rekha_lakhanpal@hcpss.org
Breyona Milam | Special Education Paraeducator - Regional Program | breyona_milam@hcpss.org
Allron Monsanto | Special Education Paraeducator | allron_monsanto@hcpss.org
Angela Sullivan | Special Education Paraeducator | angela_sullivan@hcpss.org
Denise Taylor | Special Education Paraeducator | denise_taylor1@hcpss.org
Edward Tillery | Special Education Paraeducator | edward_tillery@hcpss.org
Erin Toran | Special Education Paraeducator | erin_toran@hcpss.org
Amy Williamson | Special Education Paraeducator | amy_williamson@hcpss.org

Oakland Mills Middle School
Tracey Bailey | Special Education Teacher | tracey_bailey@hcpss.org
Robert Foyles | Special Education Teacher | robert_foyles@hcpss.org
Marissa Guzman | Special Education | Marissa_Guzman@hcpss.org
Willie Jones | Special Education Teacher | willie_jones@hcpss.org
Marissa Loro | Special Education Teacher | marissa_loro@hcpss.org
Lachonde Martin-Barwick | Special Education Teacher | lachonde_martin-barwick@hcpss.org
Allen Perrigan | Special Education Teacher | allen_perrigan@hcpss.org
Valencia Porter | Special Education Teacher | valencia_porter@hcpss.org
Wanda Kochanek | Speech/Language Pathologist | wanda_kochanek@hcpss.org
Vacancy Vacancy | Speech/Language Pathologist
Sean Wilson | Para-educator | sean_wilson@hcpss.org
Renita Frasier | Para-educator | renita_frasier@hcpss.org
Jamira Livingston | Para Educator | jamira_livingston@hcpss.org
Stephen Marsh | Para-educator | stephen_marsh@hcpss.org
Angela Stringfield | Student Assistant | angela_stringfield@hcpss.org
Trina Johnson | Para-educator | trina_johnson@hcpss.org
Julie Egleston | Physical Therapist | julie_egleston@hcpss.org
Anuradha Gopalan | Paraeducator | anuradha_gopalan@hcpss.org
Benjamin Wallace | Paraeducator | benjamin_wallace@hcpss.org
Sania Hebron | Student Assistant | sania_hebron@hcpss.org
CeeJay Jowers | Student Assistant | allah_jowers@hcpss.org 

Hammond Middle School
Kenya Bellamy | Special Education Team Leader | kenya_bellamy@hcpss.org
Andrea Bland | Special Education Teacher | andrea_bland@hcpss.org
Natarsha Burrell | Special Education Paraeducator | natarsha_burrell@hcpss.org
Melissa Choi-Kang | Special Education Teacher | melissa_choi-kang@hcpss.org
Aileen Downs | Special Education Paraeducator | aileen_downs@hcpss.org
Christine Dunkle | Special Education Paraeducator | christine_dunkle@hcpss.org
Keishanna Hunt | Special Education Teacher | keishanna_hunt@hcpss.org
Lanae McCarty | Special Education Paraeducator | lanae_mccarty@hcpss.org
Eileen Nolan | Special Education Teacher | eileen_nolan@hcpss.org
Alex Sabra | Special Education Paraeducator | alex_sabra@hcpss.org
Maureen Whelan | Special Education Paraeducator | maureen_whelan@hcpss.org
Heather Witt | Special Education Paraeducator | heather_witt@hcpss.org

Harpers Choice Middle School
Erika Benton | Special Education Teacher | erika_benton@hcpss.org
Maria Britton | Special Education Teacher | maria_britton@hcpss.org
John Dean | Special Education Teacher | john_dean@hcpss.org
Rachel Gostomski | Special Education Teacher, ALS | rachel_gostomski@hcpss.org
Tammi Lynch | Special Education Team Leader | tamara_lynch@hcpss.org
Julie Oberholtzer | Special Education Teacher | julie_oberholtzer@hcpss.org
Veronica Scrivens | Special Education Teacher | veronica_scrivens@hcpss.org
Tara Turner | Special Education Teacher | tara_turner@hcpss.org

Lake Elkhorn Middle School
Gregory Campbell | Paraeducator | gregory_campbell@hcpss.org
Ann Cherone | Paraeducator | ann_cherone@hcpss.org
Stacy Cole | Student Assistant | stacy_cole@hcpss.org
Niya Dixon | Alternative Ed. Paraeducator | niya_dixon@hcpss.org
Candice Keys-Fortune | Special Education Teacher | candice_keys-fortune@hcpss.org
Sherry Kyte | Special Education Teacher, Teacher Development Liaison | sherry_kyte@hcpss.org
Touria Laabi | Paraeducator | touria_laabi@hcpss.org
Maria Michael | Special Education Paraeducator | maria_michael@hcpss.org
Ashley Riley | 8th grade Special Education Team Leader | ashley_riley@hcpss.org
Carmen Sharpe | Paraeducator | carmen_sharpe@hcpss.org
Marlee Slaughter | Special Education Teacher | marlee_slaughter@hcpss.org
Kristen Spence | Paraeducator | kirsten_spence@hcpss.org
Tonia Washington | Paraeducator | tonia_washington@hcpss.org
Charlene Williams | Special Education Teacher | charlene_williams@hcpss.org
Cyd Perez | Special Education Teacher | cyd_perez@hcpss.org
I-shakeema Swain | Special Education Teacher | I-shakeema_Swain@hcpss.org
Liz Thurston | Special Education Teacher | liz_thurston@hcpss.org

Mayfield Woods Middle School
Ms. Alston | Special Education Paraeducator | Nicole_Alston@hcpss.org
Ms. Bailey | Speech | Meredith_Bailey@hcpss.org
Mr. Bellamy | Special Education Paraeducator | aaron_bellamy@hcpss.org
Ms. Briscoe | Pareducator | Kimberly_Briscoe@hcpss.org
Mr. Carr | School Psychologist | Daniel_Carr@hcpss.org | 410-313-5025 | Website
Mrs. Castro | Special Education Teacher | Evelyn_Castro@hcpss.org
Mrs. Conklin | Math Specialist | Brittany_Conklin@hcpss.org
Mrs. Compofelice | Special Education Teacher | Tina_Compofelice@hcpss.org
Ms. Darguin | Special Education Paraeducator | Desyr_Darguin@hcpss.org
Ms. Drummond | Special Education Teacher | LaToya_Drummond@hcpss.org
Ms. Ferreyra | Special Education Team Leader | Erin_Ferreyra@hcpss.org
Ms. Fraley | Special Education Teacher | Mary_Fraley@hcpss.org
Ms. Holliday | Special Education Paraeducator | kecia_holliday@hcpss.org
Ms. Koul | Special Education Paraeducator | meenakshi_koul@hcpss.org
Ms. Meetre | Special Education Paraeducator | Deborah_Meetre@hcpss.org
Ms. Morton | Special Education Teacher | Gabrielle_Morton@hcpss.org
Ms. Napora | Special Education Teacher | Christina_Napora@hcpss.org
Ms. Rankin | Special Education Paraeducator | Leslie_Rankin@hcpss.org
Ms. Richardson | Special Education Teacher | Jodi_Richardson@hcpss.org
Mr. Stephens | Special Education Paraeducator | matthew_stephens@hpcss.org
Ms. Shah | Special Education Teacher | sarah_shah@hcpss.org
Ms. Smith | Special Education Teacher | robin_smith@hcpss.org
Mr. Tatum | Special Education Paraeducator | John-Solomon_Tatum@hcpss.org

Mount View Middle School
Carrie Hess | Special Education Team Leader | carolyn_hess@hcpss.org
Samantha Capecci | Special Educator | samantha_capecci@hcpss.org
Michael Colonna | Special Educator | michael_colonna@hcpss.org
Kelly Moe | Special Educator | kelly_moe@hcpss.org
Andrea Montanti | Special Educator | andrea_montanti@hcpss.org
Bill Bronstein | Paraeducator | william_bronstein@hcpss.org
Prathipa Gujulva Sankarachari | Paraeducator | Prathipa_Gujulva_Sankarachari@hcpss.org
Sherry Strothers | Paraeducator | sherry_strothers@hcpss.org
Sue Tompkins | Paraeducator | susan_tompkins@hcpss.org
Tina Monroe | Student Assistant | tina_monroe@hcpss.org
Margaret Ottenritter | Student Assistant | margaret_ottenritter@hcpss.org
Cheryl Wingate | Paraeducator | cheryl_wingate@hcpss.org

Bonnie Branch Middle School
Julia D''Anna | Special Education Teacher | julia_danna@hcpss.org
Lesa Guth | Special Education Teacher | lesa_guth@hcpss.org
Alison Kaplan | Speech and Language Pathologist | alison_kaplan@hcpss.org
Hannah Kaufman | Special Education Team Leader | hannah_kaufman@hcpss.org
Cory Nance | Special Education Teacher | cory_nance@hcpss.org
Dana Burton | Special Education Teacher | dana_burton@hcpss.org
Laura Smith | Special Education Teacher and Eight Grade Team Leader | laura_smith2@hcpss.org
Christopher Ho | Special Education Teacher | christopher_ho@hcpss.org

Burleigh Manor Middle School
Jessica Petrlik | Special Education Team Leader | jessica_petrlik@hcpss.org
Tamara Colton | Speech Pathologist | tamara_colton@hcpss.org
Pamela Dennard | Paraeducator | pamela_dennard@hcpss.org
Judith Greenwald | Paraeducator | judith_greenwald@hcpss.org
Manasseh Johnson | Paraeducator | manasseh_gboffueh@hcpss.org
Jennifer Lowry | Special Education Teacher | jennifer_lowry@hcpss.org
Alyssa Peddicord | Special Education Teacher | alyssa_peddicord@hcpss.org
Andrew Shearer | Special Education Teacher | andrew_shearer@hcpss.org
Karen Camp | Special Education Teacher | karen_camp@hcpss.org
Nicole Williams | Paraeducator | nicole_williams@hcpss.org
Rachel Balis | Paraeducator | rachel_balis@hcpss.org | 410-313-2507
Chi Song | Special Education ALS Teacher | chi_song@hcpss.org | 410-313-2507
Shilpa Shetty | Paraeducator | shilpa_shetty@hcpss.org
Paula Campbell | Student Assistant | paula_campbell@hcpss.org

Clarksville Middle School
Robin Bregman | Special Education /Team Leader | robin_bregman@hcpss.org
Liz Budge | Special Education Teacher | elizabeth_budge@hcpss.org
Ian Pope | Special Education Teacher | ian_pope@hcpss.org
Doug Ripley | Special Education Teacher | douglas_ripley@hcpss.org
Srilatha Bandaru | Paraeducator | srilatha_bandaru@hcpss.org
Kathy Cheyne | Paraeducator | kathy_cheyne@hcpss.org
Mehrnoush Ghorbanali | Student Assistant | Mehrnoush_Ghorbanali@hcpss.org
Dilek Keskin | Paraeducator | dilek_keskin@hcpss.org
Georgia Lewis | Paraeducator | georgia_lewis@hcpss.org

Dunloggin Middle School
Rachel Brewer | ALS Teacher | rachel_brewer@hcpss.org
Susan Caldwell | Speech Language Pathologist | susan_caldwell@hpcss.org
Julie Davis | Special Education ITL | julie_davis@hcpss.org
Brian Fausel | Special Education Teacher | brian_fausel@hcpss.org
Heather Furno | Paraeducator | heather_furno@hcpss.org
Leslie Gulman | Paraeducator | leslie_gulman@hcpss.org
Rochelle Harrison | Student Assistant | rochelle_harrison@hcpss.org
Ronnie Jackson | Paraeducator | ronnie_jackson@hcpss.org
Melissa Mooney | Paraeducator | melissa_mooney@hcpss.org
Courtney Rabold | Special Education Teacher | courtney_rabold@hcpss.org
Kelly Riesner | Special Education Teacher | kelly_riesner@hcpss.org
Darryl Simpkins | Paraeducator | darryl_simpkins@hcpss.org
Cara Wetmiller | Special Education Teacher | cara_wetmiller@hcpss.org